0000000000
0211100310
0100100010
0111101010
0000111010
0001111110
0300011110
0111111140
0000000000
