0000000000
0211111130
0111111110
0111111110
0111111110
0111111110
0111111110
0111111110
0311111140
0000000000
