0000000000
0211101310
0111101110
0111101110
0000111110
0111111110
0311111110
0111111140
0000000000
