00000000
02110030
01110010
01111110
00000000
