00000000
02110000
01110000
01111110
00000010
03000010
01011110
01010000
01011110
01000010
01111110
00000000
