00000000
02110000
01110000
01111110
00001110
03011110
01111110
01110000
00000000
